..............#######################...............................................................................................................................
..............#                     #...............................................................................................................................
..............#                     #.................................#######################.......................................................................
..............#                     #.................................#                     #.......................................................................
..............#                     ###################################                     #.......................................................................
..............#                                                                             #.......................................................................
..............#                     #################   ###############                     #.......................................................................
..............#                     #...............#   #.............#                     #.......................................................................
..............#                     #...............#   #.............#                     #.......................................................................
..............#                     #...............#   #.............#                     #.......................................................................
..............#######################...............#   #.............#                     #.......................................................................
....................................................#   #.............###########   #########.......................................................................
....................................................#   #.......................#   #...............................................................................
....................................................#   #.......................#   #...............................................................................
....................................................#   #.......................#   #...............................................................................
....................................................#   #.......................#   #...............................................................................
....................................................#   #.......................#   #...............................................................................
.......................................##############   ######..................#   #...............................................................................
.......................................#                     #..................#   #...............................................................................
....#######################............#                     ####################   ######..........................................................................
....#                     #............#                                                 #..........................................................................
....#                     #............#                     #########################   #..........................................................................
....#                     ##############                     #.......................#   #..........................................................................
....#                                                        #.......................#   #..........................................................................
....#                     ##############                     #................########   ############...............................................................
....#                     #............#                     #................#                     #.................................................#############.
....#                     #............########   ############................#                     #.................................................#           #.
....#                     #...................#   #...........................#                     ###################################################           #.
....#                     #...................#   #...........................#                                                                                   #.
....#                     #...................#   #...........................#                     ###################################################           #.
....#                     #...................#   #...........................#                     #.................................................#           #.
....#                     #...................#   #...........................#                     #.................................................#           #.
....#                     #...................#   #...........................#                     #.................................................#           #.
....#                     #..........##########   ##########..................#                     #.................................................#           #.
....#########   ###########..........#                     #..................#                     #.................................................#           #.
............#   #....................#                     #..................#                     #.................................................#############.
............#   #....................#                     #..................#######################...............................................................
............#   ######################                     #........................................................................................................
............#                                              #........................................................................................................
............##########################                     #........................................................................................................
.....................................#                     #........................................................................................................
.....................................#                     #........................................................................................................
.....................................#                     #........................................................................................................
.....................................#                     #........................................................................................................
.....................................#######################........................................................................................................
